111111
100001
101111
1000x1
101111
101111
1000y1
111111